-#########
-#--1----#
-#-----###
-#-X-X---#
-#--0----#
-#--0-####
-#----#---
-##---#---
--#####---
----------