-#########
-#--2----#
-#-----###
-#-X----X#
-#--0----#
-#--0-####
-#----#---
-##-1-#---
--#####---
----------
Matyi, Domi, 14, 0:30